#1
XXXXXXXXXXXXXXXXXXXXXXX
X                     X
X                K    X
X  K P          XXX   X
X  XXXXX              X
X           C         X
X         XXXX        X
X               CCC   X
X              XXXXX  X
X        C            X
X       XXXX          X
X                  K  X
X                     X
XXXXXXXXXXXXXXXXXXXXXXX