#1
XXXXXXXXXXXXXXXXXXXXXXX
X                     X
X                K    X
X  K P          XXX   X
X  XXXXX              X
X                     X
X         XXXX        X
X               CCCC  X
X              XXXXX  X
X       CCC           X
X       XXXX          X
  CCC                 
              K       
XXXXXXXXXXXXXXXXXXXXXXX