XXXXXXXXXXXXXXXXXXXXXXX
X                     X
X                     X
X    P                X
X  XXXXX              X
X           C         X
X         XXXX        X
X               CCC   X
X              XXXXX  X
X        C            X
X       XXXX          X
X                  K  X
X                     X
XXXXXXXXXXXXXXXXXXXXXXX